11111111111111111111
10000000000000000001
10000000000000000001
10000000000000000001
10000000000000000001
10011110000000000001
10000000000000011101
10000000000000000001
10000000001111100001
10000000000000000001
10000000000000000001
10000000000000000001
10000011100000000001
10000000100000000001
10000000100000000001
10100000000000000001
10100000000000000001
10100000000000000001
10100000000000000001
10100100000000000001
10000100000000000001
10000100000000111111
10000100000000100001
10100111000000100001
10100000000000101001
10100000000000101001
10100000000000101001
10100000000000101001
10000000000000101001
11111111100000101001
10000000111100101001
10000000000100101001
10000000000100101001
10000000000100101001
10000000000100101001
10000000000100101001
10000000000100101001
10000000000100101001
10000000000100101001
10000000000100101001
10000000000100101001
10000000000100101001
10000000000100101001
10000000000100101001
10000000000100101001
10000000000100101001
10000000000100001001
11111111111111111001
10000000000000001001
10000000000000000001
10000000000000000001
10000000000000000001
10011111111111111111
10000000000010000001
10000000000010000001
10000000010010000001
10000000010010010001
10000000010010010001
10000000010010010001
10000000010010010001
10000000010010010001
10000000010010010001
10000000010010010001
10000000010010010001
10000000010010010001
10000000010000010001
11111111111111110001
10000000000000000001
10000000000000000001
10000000000000000111
10000000000000000001
10000000000000000001
10000000000011000001
10000000000000000001
10000000011000000001
10000000000000000001
10000110000000000001
10000000000000000001
10000000000000000001
10000000000000000001
11111111111111111111